####====%%%%####====%%%
#P..=..M.D......B.....%
###...=..%%.G.##..=.%.%
#...=.......#...=M.B..%
=M==%.%%##.#=.=.%D%%..#
=M=..T%...M...=.....G.#
=.=.%......#==..%%.%#.#
=D=.....#.#...=..G..#.#
%.%.###.=.=...%%###G..=
%.%.....=.=...%.....=.=
%G.%####=.D.....#G.#..=
%...#....M=..T..#.....=
#.#.=T.=%M%.K#.#===.%.%
#..M=B=.%MT.#...=...%.%
#...=M=GM.G.#.#.=.==..%
#M............#...=X.M%
====%%%%####====%%%%###
