##$###$###$###$###$####
#.....................#
#...T......H......T...#
#...=.G.........G.=...#
#..M....M.....M....M..#
#....B.....G.....B....#
#..M....=.....=....M..#
#.....B....M....B.....#
#..G....B.....B....G..#
#..B...M.......M...B..#
#...=......B......=...#
#..M..B.........B..M..#
#.......M.....M.......#
#...M...=..B..=...M...#
#...B.............B...#
#......M...^...M......#
##%###%###%###%###%####
